type octile -5 -2
height 100
width 100
map
@@@@@@@@@@@@@@@@@@@@@@@@@@@@@@@@@@@@@@@@@@@@@@@@@@@@@@@@@@@@@@@@@@@@@@@@@@@@@@@@@@@@@@@@@@@@@@@@@@@@
@.......@.......@.@...........@...................@.....@...@.@.........@.......@.......@...........
@.@@@@@.@@@@@.@.@.@@@.@@@@@.@@@.@.@.@@@@@@@@@@@.@.@.@@@.@.@.@.@@@.@@@@@@@.@@@.@@@.@@@@@@@@@.@@@@@@@.
@.....@.......@.....@.....@.....@.@...........@.@...@...@.@.@...@...@.....@.....@.........@.....@...
@.@@@.@@@@@@@@@@@@@@@.@@@@@@@@@@@@@@@@@@@@@.@@@.@@@@@@@.@.@.@.@@@.@.@.@.@@@.@@@.@.@@@.@@@@@@@@@.@.@@
@.@.@.................@.....@...@.....@...@.@...@.....@.@.@.@.....@...@.@.....@.@...@.......@...@...
@.@.@@@@@.@@@@@@@@@@@@@.@@@.@.@.@@@.@.@.@.@.@.@@@.@.@@@.@.@.@@@@@@@@@@@.@.@@@@@.@.@@@@@.@@@@@.@@@@@.
@.@.....@.@.........@...@.....@.@...@.@.@...@.....@...@.@.@.........@...@.@...@.@.@.....@.......@...
@.@@@.@.@@@.@@@@@.@@@.@.@.@@@@@.@.@@@.@.@@@@@@@.@@@@@.@.@.@@@@@@@@@.@.@@@.@@@.@.@@@@@@@.@.@@@@@@@@@.
@...@.@.........@.@...@.@.@...@...@...@.....@...@...@.@.....@.@.......@.@.....@.@.......@.....@...@.
@@@.@.@@@@@@@.@@@.@.@.@@@.@@@.@@@@@@@.@@@.@@@.@.@.@@@.@@@@@@@.@.@.@@@.@.@.@@@@@@@.@@@@@@@.@@@@@.@.@.
@...@...@...@.@.....@.@.....@.@.....@...@...@...@...@.....@...@.@...@...@.......@...@.....@.....@...
@.@@@@@.@.@.@@@@@@@@@.@@@.@.@.@.@@@.@@@.@@@.@.@@@@@.@.@@@.@.@@@.@@@.@.@@@@@@@.@@@@@.@.@@@@@.@@@@@@@@
@.@...@.@.@.........@...@.@...@.@...@.......@.....@.@...@.@.......@.@.......@.....@.....@.@.@.......
@.@.@@@@@.@@@.@@@@@.@.@.@.@.@@@.@.@.@@@@@@@@@@@.@@@.@@@@@.@.@@@@@@@.@@@.@@@@@.@@@.@@@@@.@.@.@.@@@.@@
@.@...@...@.@.@...@.@.@.@.@.@...@.@...@.........@.........@.@.....@.@.@.@...@.@.@.....@...@.....@...
@.@@@.@.@@@.@@@.@.@.@@@.@.@@@.@@@.@@@@@.@@@@@@@@@@@@@@@.@@@.@.@@@.@.@.@@@.@.@.@.@@@@@.@@@.@@@.@.@@@.
@.....@.@...@...@.@.@...@...@...@.@.................@.@.@.@.@...@.@.....@.@...@.....@.@.....@.@.@...
@.@@@@@.@.@@@.@.@@@.@.@.@.@@@@@@@.@.@.@.@@@@@@@.@@@@@.@.@.@@@@@@@.@@@@@.@.@@@@@.@@@.@.@@@.@@@@@.@.@@
@.@.....@.....@...@.@.@.@.......@.@.@.@.@.........@...@.@.......@.....@.@.....@.@...@...@...@...@...
@.@.@@@.@@@.@@@@@.@.@.@@@@@@@@@.@.@.@@@@@.@@@@@@@.@@@.@.@@@@@@@.@@@.@@@.@@@@@.@@@.@@@.@@@@@@@@@.@@@.
@.@...@.@.....@.......@...@.......@...@.........@...@.....@.....@...@...@...@.@.@...........@.....@.
@.@@@.@@@@@@@@@@@@@@@@@@@.@@@.@@@@@.@@@@@.@@@@@.@@@.@@@.@@@.@@@@@@@.@.@@@.@@@.@.@@@@@@@@@@@.@@@@@@@.
@...@...........@.......@.....@...@...@...@.....@...@.....@.....@.....@.......@.....@.....@.........
@.@@@@@@@.@.@@@@@@@.@@@.@@@@@@@.@.@@@.@.@@@.@@@.@.@@@.@@@@@@@@@.@@@@@.@.@.@@@@@@@.@.@.@@@@@.@@@@@@@@
@.@...@...@.@.......@.....@...@.@.....@...@.@...@...@...@.......@...@.@.@.@.@.....@.@...@...@.......
@.@@@.@.@@@@@.@@@@@@@.@.@@@.@.@.@@@@@@@@@.@.@@@.@.@@@@@.@.@@@@@@@.@.@@@.@@@.@.@.@@@.@@@.@@@.@@@@@.@@
@.....@.....@.@.@.@...@.....@...@.........@.@...@.....@.@...@.....@.@.......@.@.@.@.@...........@...
@@@@@@@@@@@.@.@.@.@@@.@@@.@@@@@@@.@@@@@@@@@.@.@@@@@@@.@.@@@.@.@@@@@.@.@@@@@@@.@@@.@@@.@@@@@@@@@.@@@.
@...........@...@.......@.......@...@.......@.@.......@...@.@.@.@...@.....@...@.....@.@.........@...
@.@@@@@@@@@@@@@.@.@@@@@@@@@@@@@.@@@.@.@@@.@.@.@.@@@@@@@.@@@.@.@.@@@@@.@.@.@.@@@.@@@.@.@@@.@@@@@@@.@@
@.........@.....@.@...@.......@.....@.@...@.@...@.........@.@.......@.@.@.@.....@...@...@.......@...
@.@@@@@@@.@.@@@@@.@.@@@.@@@@@.@@@@@@@.@.@.@@@@@@@@@@@@@@@.@.@@@.@@@.@.@@@.@@@@@@@.@.@@@@@.@@@@@.@@@.
@.......@.....@.....@...@...@...@.....@.@...........@...@.@...@.@.@...@.......@...@.@.....@...@.@...
@.@@@@@@@@@.@@@.@@@@@.@@@@@.@@@.@.@@@@@.@.@@@@@@@@@.@.@.@.@@@.@.@.@@@@@@@@@@@.@.@@@@@@@@@@@.@@@.@.@@
@.@.......@.@...@.@...@.@.........@.....@.......@...@.@.@.@...@...@.@.....@...@.@...@.....@...@.@...
@.@.@@@.@@@.@.@@@.@.@@@.@@@@@@@@@@@.@.@@@.@.@@@@@.@@@.@.@.@.@@@.@@@.@.@@@.@@@@@.@.@.@@@.@.@.@@@.@@@.
@.@...@...@.@.@...@...@.............@.@...@.@.....@...@.@.....@.@.....@.@.@.....@.@.@...@...@.@...@.
@@@@@.@@@.@@@.@.@@@@@.@.@@@@@.@.@@@@@@@.@.@@@.@@@@@.@@@.@@@@@.@@@.@.@@@.@.@.@@@@@.@@@.@@@@@.@.@@@.@.
@...@...@.@.@.@.........@.....@.@.@.....@...@.....@...@...@.......@.@.@.....@.............@.@...@...
@@@.@@@.@.@.@.@@@@@@@@@@@.@@@@@@@.@.@@@@@.@@@@@@@.@@@.@.@@@@@.@@@@@@@.@@@.@@@.@@@@@@@@@@@.@@@.@@@@@.
@.@.....@...@.......@.....@.....@.......@...@.......@.@.....@.@...@.....@.@.@.@.@.........@...@.....
@.@@@@@@@@@.@@@.@@@.@@@.@@@.@.@@@@@@@.@@@.@.@.@.@.@@@.@@@@@.@@@.@.@.@@@@@@@.@.@.@.@@@.@@@@@.@@@.@@@@
@...@.........@.@.@.@.....@.@.........@...@...@.@.@.....@.......@.@.....@...@.@.@...@.@.......@...@.
@@@.@.@@@@@@@.@.@.@.@@@@@.@.@@@@@.@.@@@.@@@@@.@@@@@@@@@.@.@@@@@@@.@.@@@.@.@.@.@.@@@.@@@@@.@@@.@.@@@.
@...@.@.....@...@...@...@.@...@.@.@.@.....@...@.........@.@.......@.@.@...@.@.....@.@.....@...@...@.
@.@.@.@@@.@@@@@@@.@@@@@.@.@@@.@.@@@.@.@@@.@@@@@.@.@@@@@@@.@@@.@@@@@@@.@.@.@@@@@.@@@.@.@@@@@@@.@.@@@.
@.@.@...@.....@...@.....@...@...@...@...@.@.....@...@...@.@.@.@.....@...@.@.....@...@.@...@...@.....
@.@@@@@.@.@.@@@.@@@@@@@.@.@@@.@@@.@@@@@.@@@.@.@@@.@@@.@.@.@.@.@.@@@@@.@@@@@.@@@@@.@@@.@@@.@@@.@.@@@@
@.....@.@.@.@...@.......@...@.@...@.......@.@...@.@...@.@...@...@.@.@...........@.@.......@.@...@...
@@@@@.@.@.@.@.@@@.@@@@@.@@@.@.@@@.@@@.@@@@@.@@@.@@@.@@@.@@@@@@@.@.@.@@@@@@@@@@@@@.@@@@@@@@@.@.@@@@@.
@.....@.@.@.@.@.@...@.@...@.@...@...@.......@...@...@...@.....@.@...........@.@.............@.......
@@@@@.@.@@@.@.@.@@@.@.@.@.@.@@@@@@@.@@@@@@@@@.@@@.@@@.@@@.@@@.@@@.@@@.@@@@@.@.@@@.@@@@@@@@@.@@@@@@@.
@.@...@.....@.@...@.@.@.@...@...............@.....@.@.@.....@...@.@.@.@.....@...@.@.......@.@...@...
@.@@@.@@@.@@@.@.@.@.@.@.@@@@@.@@@@@@@@@@@.@@@@@@@@@.@.@@@@@.@@@.@@@.@@@@@.@@@.@@@.@.@@@@@.@.@@@.@@@.
@.......@...@.@.@.@.@...@.......@.................@.@.@...@...@.......@...@...@...@.@.....@.......@.
@.@@@@@.@@@.@.@@@.@.@.@@@@@@@.@.@.@@@@@@@.@.@@@.@.@.@.@.@.@.@@@@@@@@@.@.@@@@@.@.@@@.@.@@@.@@@@@@@.@.
@...@...@...@.@...@.@.......@.@.@...@.....@.@...@.@.@...@...@.@...@.....@.....@.@...@...@.@...@...@.
@.@.@@@@@.@@@.@@@.@.@@@@@@@.@.@.@@@.@.@.@@@@@.@@@.@.@.@@@@@@@.@.@@@.@@@@@.@@@@@.@@@@@@@.@.@.@.@.@.@@
@.@.......@.@.@...@.@.....@.@.@.....@.@.......@.....@.@.@.........@.@.@.................@.@.@...@...
@.@@@@@@@@@.@.@.@@@.@.@.@@@.@@@@@.@@@.@@@@@@@@@@@@@@@.@.@@@.@@@@@.@.@.@.@@@@@@@@@@@@@@@.@@@.@@@@@@@.
@...@.......@.@.@.@.@.@...@.....@.@.......@.......@.......@.@...@...@.@...@...@...........@.@.@...@.
@.@@@@@@@@@.@.@.@.@.@@@.@.@@@@@.@.@.@@@@@.@.@@@@@.@@@@@@@.@.@@@.@@@@@.@.@@@.@@@@@@@@@@@@@@@.@.@.@@@.
@.@.........@.@...@.....@...@.@.@.@.@...@.....@.......@...@.....@.....@.@.....@.............@.......
@.@.@@@@@.@@@.@.@@@@@@@.@@@.@.@.@.@.@.@.@@@@@@@.@@@.@.@@@@@.@@@@@.@@@@@.@.@@@@@.@@@@@@@@@@@@@@@.@.@@
@...@.@.....@.@.@.....@.@.@...@.@.@...@.......@.@...@.........@...@...@.@.....@.....@.....@.....@.@.
@@@@@.@.@@@@@.@.@@@.@@@@@.@@@.@.@.@@@@@@@.@.@.@.@@@.@@@@@.@@@.@.@@@.@.@.@@@.@@@@@@@.@.@.@.@.@@@.@@@.
@.@.......@...@...@...@.......@.@...@.....@.@...@...@.....@...@.....@.......@.......@.@.@.@...@.....
@.@.@@@.@@@@@@@.@@@.@.@@@@@@@@@.@@@.@.@@@.@.@@@@@.@@@.@@@@@.@@@.@@@@@@@@@@@@@.@@@@@@@.@@@.@@@.@.@@@@
@.....@...@...@.....@.............@...@...@.........@.....@.@.@...@.....@...@.....@...@.@.@...@.@...
@.@@@@@@@@@.@.@.@@@@@@@@@@@.@.@@@@@@@@@.@@@@@@@@@.@@@.@@@.@.@.@@@.@@@@@.@.@.@@@.@.@.@@@.@.@.@@@.@@@.
@.@.........@...@.....@.@.@.@.@.......@...@.@.........@...@.@.@...@.....@.@.....@.@.@.....@...@.@...
@.@@@.@@@@@@@@@@@.@@@.@.@.@@@@@@@@@.@.@@@.@.@@@.@@@@@.@.@.@.@.@@@.@.@@@@@.@@@@@@@@@.@.@@@@@@@@@.@.@@
@.@.@.@...@.......@.....@.@.........@...@.....@...@.@.@.@.@.....@.@.@.....@.........@.........@...@.
@.@.@.@.@@@.@@@@@@@@@@@.@.@@@.@.@.@.@@@.@.@.@@@@@.@.@.@.@@@.@@@@@.@.@.@@@.@.@.@@@@@@@@@.@@@@@@@@@.@.
@.@.@.@...@.......@.........@.@.@.@...@.@.@.@.@.@.@.@.@...@...@.....@...@.@.@.@.@.........@...@...@.
@.@.@@@.@.@@@@@@@.@@@@@@@@@.@@@@@.@@@.@.@@@@@.@.@.@.@@@@@.@@@.@@@@@.@@@.@@@.@.@.@.@.@@@@@.@@@.@@@.@.
@.....@.@.....@.......@.@.....@.....@.@.......@...@.........@.@.......@.....@.@.@.@...@...@.....@...
@.@@@.@@@@@@@.@@@.@@@.@.@.@@@@@@@@@@@.@@@@@@@.@.@@@@@.@.@@@.@.@@@@@@@@@@@@@@@.@.@@@@@.@@@.@.@.@@@@@@
@.@...@.......@...@...@...@.......@...@...@.@.@.....@.@.....@.@...............@.....@...@...@.@.....
@@@@@.@.@@@@@.@@@@@.@@@.@@@.@@@@@.@.@@@.@.@.@.@.@.@@@.@.@@@.@.@@@.@@@@@@@@@@@@@@@.@.@.@@@@@@@@@.@@@.
@.@.@.@.@...@.......@...@...@.....@.....@.@...@.@.@...@...@.@...@.....@.........@.@.@.@.....@...@...
@.@.@.@.@@@.@@@@@@@@@.@@@.@.@@@@@.@.@@@@@.@.@@@.@@@@@.@.@.@@@.@@@.@@@.@@@@@.@.@@@@@.@.@@@@@.@.@@@.@@
@...@.@.@...@.......@.....@.@...@.@...@...@...@.@.....@.@.....@.....@.@.....@...@...@.@.........@...
@@@.@.@.@.@@@.@@@@@.@@@.@@@@@@@.@.@.@@@.@@@@@@@.@.@.@@@.@.@@@@@@@@@@@.@.@@@@@.@@@.@.@.@.@@@@@@@@@.@@
@...@...@.....@.......@.@.......@.@.@.......@...@.@...@.@...@.........@.....@.@...@.@.@.......@.....
@@@.@@@@@.@@@@@.@@@@@@@@@@@.@@@.@.@.@@@.@@@@@.@@@@@.@.@.@.@.@.@@@@@@@@@.@@@.@@@.@.@@@.@@@@@@@.@@@@@.
@.......@.@...@.............@.@.@.@.@...@.....@...@.@.@.@.@.@...@.....@.@.....@.@.@...@...@.@.@.....
@.@@@@@@@.@.@.@@@@@@@@@@@.@@@.@@@.@@@.@@@.@@@@@.@.@@@.@.@.@.@@@.@@@.@@@.@@@.@.@.@@@@@.@.@.@.@.@.@@@.
@.......@.@.@...........@...@.....@.....@.@...@.@...@.@.@.@.....@...@...@...@.@.....@...@.@...@.@...
@@@.@@@.@.@@@.@.@@@@@.@.@@@.@.@@@@@.@@@@@.@.@@@.@@@@@.@.@.@@@.@.@.@@@.@@@.@@@.@.@@@.@@@@@.@@@.@.@@@@
@.@.@...@...@.@...@...@...@.........@.....@.....@.......@...@.@.@.....@.@...@.@...@.....@.@...@.....
@.@.@@@.@@@.@@@@@@@.@@@@@.@@@@@.@@@@@@@.@@@.@@@@@.@@@.@@@.@.@.@.@.@@@@@.@@@.@.@@@@@.@@@.@.@@@.@@@@@.
@.@.@.@...@.@.........@.....@.@...@...@.@...@.......@...@.@.@.@.@.@.....@...@.....@...@.@.@.....@...
@.@.@.@@@.@.@@@@@.@@@@@@@@@.@.@@@@@.@.@.@.@.@@@@@@@@@@@.@@@.@.@.@.@@@@@.@.@@@@@.@.@@@.@@@.@.@@@@@.@.
@.@...@...@.@...@.......@.....@.....@.@.@.@.......@...@.....@.@.@...@...@...@.@.@.@...@...@.@.....@.
@.@.@@@@@.@.@.@.@@@.@.@@@@@@@.@.@@@@@.@.@@@@@@@@@.@@@.@@@@@@@.@.@@@.@@@.@@@.@.@@@.@.@@@.@@@.@.@@@@@.
@.@.@.....@.@.@...@.@.@.@.@.....@.....@.@.........@...........@.@.........@.@...@.@.@...@...@.@...@.
@.@.@@@.@@@.@.@@@.@.@@@.@.@.@@@.@.@@@@@.@.@@@@@@@@@.@@@.@@@@@@@.@@@@@@@@@@@.@.@@@.@.@.@@@@@@@.@.@@@.
@.....@.........@...@.........@.@...@.........@.......@.....................@.......@.........@.....
